%%%%%%%%%
%P     G%
% % % % %
%       %
% % % % %
%       %
% % % % %
%G      %
%%%%%%%%%
