%%%%%
%P  %
% %.%
% .G%
%%%%%
