%%%%%%%%%
%P      %
% %%%%% %
% %%%%% %
% %%%%% %
% %%%%% %
% %%%%%.%
%     .G%
%%%%%%%%%
