%%%%%%%%%%%%%
%...P  GG...%
%%%%%%%%%%%%%