%%%%%%%%%
%G .P  .%
%%%%%%%%%
